NO textures/west.xpm
SO textures/west.xpm
WE textures/west.xpm
EA textures/east.xpm

F 20,20,20
C 200,200,200

1111111111111111111111111111111111111111
10000000000000000000000000000000000000E1
1111111111111111111111111111111111111111
