NO textures/1.xpm
SO textures/2.xpm
WE textures/3.xpm
EA textures/4.xpm

F 164,169,20
C 153,204,255

111111111111111111111
101011111111111010101
100010000000000010001
101010111011111111101
1W1000001000000000001
111111111111111111111
