SO ./path_to_the_south_texture
NO ./path_to_the_north_texture
WE ./path_to_the\ _west_texture
EA ./path_to_the_east_texture

F 220, 100, 0
C 225, 30, 0

1111dadasd
1001
1111
