SO ./path_to_the_south_texture
NO ./path_to_the_north_texture
WE ./path_to_the\ _west_texture
EA ./path_to_the_east_texture

F 220, 100, 0
C 225, 30, 0

d29348209jfiowdjfw
fwef0weuf092io2-1i201ofwedfs
fsdfspofjsduf023i0-i32094u324
fdfjiu239u023i4u923rifkdsf
f023ur93jfiu9fuds023

11111
10001
11111

1111
1001
1111
