SO ./path_to_the_south_texture
NO ./path_to_the_north_texture
WE ./path_to_the\ _west_texture
EA ./path_to_the_east_texture

F 220, 100, 0
C 225, 30, 0

1111111111111111111111111111111
10N0000001000000000000000100001
1000000001000000000000000000001
1000000000000000000000000111111
1000000001000000000000000000001
1000000001000000000000000000001
1000000000000000000000000000001
1111111111111111111111111111111
