SO ./path_to_the_south_texture                                     
NO ./path_to_the_north_texture



         EA ./path_to_the_east_texture


 C 225, 30, 0
F 255,                                100, 0
WE ./path_to_the\ _west_texture

1111111111111111111111111111111
111000001000000000000000100001
1010000001000000000000000000001
100000000000S000000000000111111
1000000001000000000000000000001
1000000001000000000000000000001
1000000000000000000000000000001
1111111111111111111111111111111
1
